BBBBBBBBBBBBBBBBBBBBBBBBBBBBBBBBBBBBBBBBBBBBBBBBBB
BCDBBBBBBBBBBBBBBBBBBBBBBBCDBBBBBBBBAAAAAAAAAAAAAB
BAHBAAAAAAAAAAAAAAAAAAAAABAABBBBBBBBAAAIAAAAAIAAGB
BAABAAAAAAAAAIAAAIAAAIAAABAABBBBBBBBAABBBBBBBBBBBB
BAABAAABBAABBBIBBBGBBBAAABAABBBBBBBBAABBBBBBBBBBBB
BAABAAABBAABBBBBBBBBBBAAABAABBBBBBBBAAAAAAAAAAAAAB
BAABAAABBAABBBBBBBBBBBAAABAABBBBBBBBAAIAAAAAAAAAAB
BAABAAAABAAAAAAAAAAAAAAAABAABBBBBBBBBBBBBBBBBBBAAB
BAABAAAABAAAAAAAAAAAAAAAABAABBBBBBBBBBBBBBBBBBBAAB
BAABAAAABBAAABBBBBBBBAAAABAABBBBBBBBAAAAAAAAAAAAAB
BAABAAAABDBAAAAAAAAABAAAABAABBBBBBBBAAAAAAAAAAAIAB
BAAAAAAABADBAAAAAAAABAAAAAAABBBBBBBBAAAFBBBBBBBBBB
BAAAAAAABAADBAAAAAAABAAAAAAABBBBBBBBAAFBBBBBBBBBBB
BAABAAAABAAADBAAAAAABAAAABAABBBBBBBBAABBBBBBBBBBBB
BAABAAAABAAAADBAAAAABAAAABAABBBBBBBBAABBBBBBBBBBBB
BAABAAAABAAAAADBAAAABAAAABAABBBBBBBBAAAAAAAAAAABBB
BAABAAAABAAAAAADBAAABAAAABAABBBBBBBBAAAAAIAAAAABBB
BAABAAAABAAAAAAAAAAABAAAABAABBBBBBBBAABBBBBBBAABBB
BAABAAAABAAAAAAAAAAABAAAABAABBBBBBBBAABBBBBBBAABBB
BAABAAAABAAAAAAAABAABAAAABAABBBBBBBBAABBBBBBBAABBB
BAABAAAABAAAAAAABCAABAAAABAABBBBBBBBAABBBBBBBAABBB
BAABAAAABAAAAAABCAAABAAAABAABBBBBBBBAABBBBBBBAABBB
BAABAAAABAAAAABCAAAABAAAABAABBBBBBBBAABBBBBBBAABBB
BAABAAAABAAAABCAAAAABAAAABAABBBBBBBCAABBBBBBBAABBB
BAABAAAABAAABCAAAAAABAAAABAABBBBBBCAAFBBBBBBBAABBB
BAABAAAAAAABCAAAAAAABAAAABAABBBBBCAAFBBBBBBBBAABBB
BAABAAAAAABCAAAAAAAABAAAABAADBBBCAAFBBBBBBBBBAABBB
BAABAAAAABCAAAAAAAAABAAAABEAAAAAAAFBBBBBBBBBBAABBB
BAIBAAAIBBGAAAAAAAAIBIAAGBBEAAAAAFBBBBBBBBBBBAGBBB
BBBBBBBBBBBBBBBBBBBBBBBBBBBBBBBBBBBBBBBBBBBBBBBBBB
BBBBBBBBBBBBBBBBBBBBBBBBBBBBBBBBBBBBBBBBBBBBBBBBBB
BBBBBBBBBBBBBBBBBBBBBBBBBBBBBBBBBBBBBBBBBBBBBBBBBB
