BBBBBBBBBBBBBBBBBBBBBBBBBBBBBBBBBBBBBBBBBBBBBBBBBB
BBBBBBBBBBBBBBBBBBBBBBBBBBCAAAAAAAAAAAAAAAAAAAAADB
BBBBBCAAAAAAAAADBBBBBBBBBCAAAAAAAAAAAIAAAAAAAAAAAB
BBBBCAAAAAAAAAAABBBBBBBBBAAAAFBBBBBBBBBBBBBBBBEAAB
BBBCAAAAAAAAAGAFBCAAAAAAAAAAFBBCAAAAAAAAAAAAADBAAB
BBBAAAAFBBBBBBBBBAAAAAAAAAAABBBAAAAAAAAAAAAAAABAAB
BBBAAAABBBBBBBBBBEAAIAAAAAAADBBEAGAAAAAAAAAAAABAAB
BBBAAAADBBBBBBBBBBBBBBBBBAAAADBBBBBBBBBBBAAAAABAAB
BBBAAAAAAAAAAADBBBBBBBBBBEAAAAAAAAAAAAAAAAAAAABAAB
BBBAAAAAAAAAAAABBBBBBBBBBBEAAAAAAAAAAAAAAAAAAFBAAB
BBBAAAAAAAAAAAABBBBBBBBBCDBEAAAAAAAIAAAAAAAAFBBAAB
BBBAAAAAAFBBEAABBBBBBBBBAABBBBBBBBBBBBBBBBBBBBBAAB
BBBAAAAAABBBBAABBBBBBBBBAABBBBBBBBBBBBBBBBBAADBAAB
BBBAAAAAABBBBAAAAAAAIAAAAAAAAAAIAAAAAAAAAAAAGFBAAB
BBBAAAAAABBBBAABBBBBBBBBBBBBBBBBBBBBBBBBBBBBBBCAAB
BBBEAAAAABBBBAACCCCCCCCCCCCCCCCCCCCCCCCCCCCCCCAAAB
BBBBBEAAABBBBAAAAAAAAAAAAAAAAAAAAAAAAAAAAAAAAAAAAB
BBBBBBAAABBBBAABBBBBBBBBBBBAAABBBBBBBBBBBBBBEAAAAB
BBBBBBAAABBBBAABBBBBBBBBBBBAAABBBBBBBBBBBBBBBAAAAB
BBBBBBAAABBBBAABBBBCAAAAAAAAAABBBBBBBBBBBBBBBAAAAB
BBBBBBAAABBBBAABBBBAAAAAAIAAAFBBBBBBBBBBBBBBBAAAAB
BBBBBBAAABBBBAABBBBAAFBBBBBBBBBBBBBBBBBBBBBBCAAAAB
BBBBBBAAABBBBAABBBBAABBBBBBBBBBBBBBBBCAAAAAAAAAAAB
BBBBBBAAADBBCAABBBBAABBBBBBBBBBBBBBBBAAAAAAAAAAAAB
BBBBBBAAAAAAAAABBBBAABBBBBBBBBBBBBBBBAAFBBBBEAAAAB
BBBBBCAAAAAAAAABBBBAABBBBBBBBBBBBBBBBAABBBBBBAAAAB
BAAAAAAAAAAAAAABBBBAABBBBBBBBBBBBBBBBAABBBBBBAAAAB
BAAAAAAAFBBBBBBBBBCAADBBBBBBBBBBBBBBCAABBBBBBAAAAB
BAAAAAAFBBBCAAAAAAAAAADBBBBBBBBBBBBCAAABBBBBBAAAAB
BAAAAAABBBBAAAAAAAAAAAAAAAAAAAAAAAAAAAAAAAADBAAAAB
BEAHAAABBBBEAGAAAAAIAAAAAAAAAAAAAAIAAAAAAAAFBEIIFB
BBBBBBBBBBBBBBBBBBBBBBBBBBBBBBBBBBBBBBBBBBBBBBBBBB
