BBBBBBBBBBBBBBBBBBBBBBBBBBBBBBBBBBBBBBBBBBBBBBBBBB
BBBBBBBBBBBBBBBBBBBBBBBBBBCAAAAAAAAAAAAAAAAAAAAADB
BBBBBCAAAAAAAAADBBBBBBBBBCAAAAAAAAAAAAAAAAAAAAAAAB
BBBBCAAAAAAAAAAABBBBBBBBBAAAAFBBBBBBBBBBBBBBBBEAAB
BBBCAAAAAAAAAGAFBCAAAAAAAAAAFBBCAAAAAAAAAAAAADBAAB
BBCAAAAFBBBBBBBBBAAAAAAAAAAABBBAAAAAAAAAAAAAAABAAB
BBAAAAABBBBBBBBBBEAAAAAAAAAADBBEAAAAAAAAAAAAAABAAB
BBAAAAADBBBBBBBBBBBBBBBBBAAAADBBBBBBBBBBBBBAAABAAB
BBAAAAAAAAAAAADBBBBBBBBBBEAAAAAAAAAAAAAAAAAAAABAAB
BBAAAAAAAAAAAAABBBBBBBBBBBEAAAAAAAAAAAAAAAAAAFBAAB
BBAAAAAAAAAAAAABBBBBBBBBBBBEAAAAAAAAAAAAAAAAFBBAAB
BBAAAAAAAFBBEAABBBBBCDBBBBBBBBBBBBBBBBBBBBBBBBBAAB
BBAAAAAAABBBBAABBBBBAABBBBBBBBBBBBBBBBBBBBBBBBBAAB
BBAAAAAAABBBBAABBBBBAABBBBBBBBBBBBBBBBBBBBBBBBBAAB
BBAAAAAAABBBBAABBBBBAABBBBBBBBBBBBBBBBBBBBBBBBCAAB
BBEAAAAAABBBBAAAAAAAAAAAAAAAAAAAAAAAAAAAAAAAAAAAAB
BBBBBEAAABBBBAAAAAAAAAAAAAAAAAAAAAAAAAAAAAAAAAAAAB
BBBBBBAAABBBBAABBBBBBBBBBBBCAABBBBBBBBBBBBBBEAAAAB
BBBBBBAAABBBBAABBBBBBBBBBBCAAABBBBBBBBBBBBBBBAAAAB
BBBBBBAAABBBBAABBBBCAAAAAAAAAABBBBBBBBBBBBBBBAAAAB
BBBBBBAAABBBBAABBBBAAAAAAAAAAABBBBBBBBBBBBBBBAAAAB
BBBBBBAAABBBBAABBBBAAAAAAAAAAFBBBBBBBBBBBBBBBAAAAB
BBBBBBAAABBBBAABBBBAAFBBBBBBBBBBBBBBBBBBBBBBBAAAAB
BBBBBBAAADBBCAABBBBAABBBBBBBBBBBBBBBBBBBBBBBBAAAAB
BBBBBBAAAAAAAAABBBBAABBBBBBBBBBBBBBBBBBBBBBBBAAAAB
BBBBBCAAAAAAAAABBBBAABBBBBBBBBBBBCDBBBBBBBBBBAAAAB
BAAAAAAAAAAAAAABBBBAABBBBBBBBBBBBAABBBBBBBBBBAAAAB
BAAAAAAAFBBBBBBBBBCAADBBBBBBBBBBBAABBBBBBBBBBAAAAB
BAAAAAAFBBBCAAAAAAAAAAAAAAAAAAAAAAAAAAAAAAADBAAAAB
BAAAAAABBBBAAAAAAAAAAAAAAAAAAAAAAAAAAAAAAAAABAAAAB
BEAAAAABBBBEAGAAAAAAAAAAAAAAAAAAAAAAAAAAAAAFBEAAFB
BBBBBBBBBBBBBBBBBBBBBBBBBBBBBBBBBBBBBBBBBBBBBBBBBB
