BBBBBBBBBBBBBBBBBBBBBBBBBBBBBBBBBBBBBBBBBBBBBBBBBB
BBBBBBBBBBBBBBBBBBBBBBBBBBCAAAAAAAAAAAAAAAAAAAAADB
BBBBBCAAAAAAAAADBBBBBBBBBCAAAAAAAAAAAAAAAAAAAAAAAB
BBBBCAAAAAAAAAAABBBBBBBBBAAAAFBBBBBBBBBBBBBBBBEAAB
BBBCAAAAAAAAAGAFBCAAAAAAAAAAFBBCAAAAAAAAAAAAADBAAB
BBBAAAAFBBBBBBBBBAAAAAAAAAAABBBAAAAAAAAAAAAAAABAAB
BBBAAAABBBBBBBBBBEAAHAAAAAAADBBEAGAAAAAAAAAAAABAAB
BBBAAAADBBBBBBBBBBBBBBBBBAAAADBBBBBBBBBBBAAAAABAAB
BBBAAAAAAAAAAADBBBBBBBBBBEAAAAAAAAAAAAAAAAAAAABAAB
BBBAAAAAAAAAAAABBBBBBBBBBBEAAAAAAAAAAAAAAAAAAFBAAB
BBBAAAAAAAAAAAABBBBBBBBBCDBEAAAAAAAAAAAAAAAAFBBAAB
BBBAAAAAAFBBEAABBBBBBBBBAABBBBBBBBBBBBBBBBBBBBBAAB
BBBAAAAAABBBBAABBBBBBBBBAABBBBBBBBBBBBBBBBBAADBAAB
BBBAAAAAABBBBAAAAAAAAAAAAAAAAAAAAAAAAAAAAAAAGFBAAB
BBBAAAAAABBBBAABBBBBBBBBBBBBBBBBBBBBBBBBBBBBBBCAAB
BBBEAAAAABBBBAACCCCCCCCCCCCCCCCCCCCCCCCCCCCCCCAAAB
BBBBBEAAABBBBAAAAAAAAAAAAAAAAAAAAAAAAAAAAAAAAAAAAB
BBBBBBAAABBBBAABBBBBBBBBBBBAAABBBBBBBBBBBBBBEAAAAB
BBBBBBAAABBBBAABBBBBBBBBBBCAAABBBBBBBBBBBBBBBAAAAB
BBBBBBAAABBBBAABBBBCAAAAAAAAAABBBBBBBBBBBBBBBAAAAB
BBBBBBAAABBBBAABBBBAAAAAAAAAAABBBBBBBBBBBBBBBAAAAB
BBBBBBAAABBBBAABBBBAAAAAAAAAAFBBBBBBBBBBBBBBCAAAAB
BBBBBBAAABBBBAABBBBAAFBBBBBBBBBBBBBBBCAAAAAAAAAAAB
BBBBBBAAADBBCAABBBBAABBBBBBBBBBBBBBBBAAAAAAAAAAAAB
BBBBBBAAAAAAAAABBBBAABBBBBBBBBBBBBBBBAAFBBBBEAAAAB
BBBBBCAAAAAAAAABBBBAABBBBBBBBBBBBBBBBAABBBBBBAAAAB
BAAAAAAAAAAAAAABBBBAABBBBBBBBBBBBBBBBAABBBBBBAAAAB
BAAAAAAAFBBBBBBBBBCAADBBBBBBBBBBBBBBCAABBBBBBAAAAB
BAAAAAAFBBBCAAAAAAAAAADBBBBBBBBBBBBCAAADBBBBBAAAAB
BAAAAAABBBBAAAAAAAAAAAAAAAAAAAAAAAAAAAAAAAADBAAAAB
BEAAAAABBBBEAGAAAAAAAAAAAAAAAAAAAAAAAAAAAAAFBEAAAB
BBBBBBBBBBBBBBBBBBBBBBBBBBBBBBBBBBBBBBBBBBBBBBBBBB
