BBBBBBBBBBBBBBBBBBBBBBBBBBBBBBBBBBBBBBBBBBBBBBBBBB
BBBBBBBBBBBBBBBBBBBBBBBBBBBBBBBBBBBBBBBBBBBBBBBBBB
BBBBBBBBBBBBBBBBBBBBBBBBBBBBBBBBBBBBBBBBBBBBBBBBBB
BBBAAAAAAAAAAAAAAAAAAAAAAAAAAAAAAAAAAAAAAAAAAAABBB
BBBAAAAAAAAAAAAAAIAAAAAAAIAAAIAAAAAAIAAAAAAAAAABBB
BBBAAAAAAAAAAIAAABBBAIABBBAHABBBAAIBBBAAAAAAAAABBB
BBBAAAAAAAABBBBBBBBBBBBBBBBBBBBBBBBBBBBBBAAAAAABBB
BBBAAAAAAABBBBBBBBBBBBBBBBBBBBBBBBBBBBBBBBAAAAABBB
BBBAAAAAABCAAAAAAAAAAAAAAAAAAAAAAAAAAAABBDBAAAABBB
BBBAAAAABCAAAAAAAAAAIAAAAIAAAAAAAAAAAAABBADBAAABBB
BBBAAAABCAAAAAAAAAABBBBBBBBBBBAAAAAAAAABBAADBAABBB
BBBAAABCAAAAAAAAAABBBBBBBBBBBBBAAAAAAAABBAAADBABBB
BBBAABCAAAAAAAAAABCAAABBAAAAAADBAAAAAAABBAAAAAABBB
BBBAAAAAAAAAAAAIBCAIAGBBAAAAAAADBAAAAAABBAAAAAABBB
BBBAAAAIAAAAIAABBBBBBBBBAAAAAAAADBAAAAABBAAAIBBBBB
BBBBBBBBBBBBBBBBBBBBBBBBAAAAAAAAADBAAAABBAAABBBBBB
BBBBBBBBBBBBBBBBBBBBBBBBAAAAAAAAAADBAAABBAABCAABBB
BBBBBBCAAAAAAAAAAAAAAABBAAAAAAAAAAADBAABBABCAAABBB
BBBBBCAAAAIAAAIAAAIAAGBBAAAAAAAAAAAAAAABBAAAAAABBB
BBBBCAAABBBBBBBBBBBBBBBBAAAAAAAAAIAAAAABBAAAAAABBB
BBBCAAABBBBBBBBBBBBBBBBBAAAAAAAABBBBBBBBBBBIAAABBB
BBBAAABBBBBBBBBBBBBBBBBBAAAAAAABBBBBBBBBBBBBAAABBB
BBBAABCABABABABABABABAAAAAAAAABBABABABABBAADBAABBB
BBBAAAAABABAAABAAABABAAAAAAAIBCAABABAAABBAAADBABBB
BBBAAAAABAAAAAAAAAAABAAAAAAABBAAAAABAAABBAAAAAABBB
BBBAAAAAAAAAIAAAIAAAAAAAAAABCAAIAAAAAIABBAAAAAABBB
BBBAAAAAAAIABAIABAIAAAAAAABBAAABAIAAABABBAAAIBBBBB
BBBAAAAAIABABABABABAIAAAABCBAIABABAIABABBAAABBBBBB
BBBGAAAABABIBABIBABIBAAABBABABIBABABIBGBBGABBBBBBB
BBBBBBBBBBBBBBBBBBBBBBBBBBBBBBBBBBBBBBBBBBBBBBBBBB
BBBBBBBBBBBBBBBBBBBBBBBBBBBBBBBBBBBBBBBBBBBBBBBBBB
BBBBBBBBBBBBBBBBBBBBBBBBBBBBBBBBBBBBBBBBBBBBBBBBBB
