BBBBBBBBBBBBBBBBBBBBBBBBBBBBBBBBBBBBBBBBBBBBBBBBBB
BAAAAAAAAAAAAAAAAAAAAAADBBBBBBBBBBBBBBBBBBBBAAAAAB
BAAAAAAAAAAAAAAAAAAAAAAADBBBBBBBBBCBBBBBBBBBAAAAAB
BGAAAAAAIAAAIAAAIAAAIAAAABDBBBBBBCABBBBBBBBBAAAAHB
BBBBBBBBBBBBBBBBBBBBBEAAABADCDBBCAABBBBBBBBBAAABBB
BBBBBBBBBBBBBBBBBBBBBBAAABAAAADCAAABBAAAAABBAAABBB
BBBBBBBBBBBBBBBBBBBBBCAAABAAAAAAAAGBBAAAAABBAAABBB
BBCAAAAAAAAAAAAAAAAAAAAAABAAAAAAAFBBBIAGAIBBAAABBB
BCAAAAAAAAAAAAAAAAAAAAAAFBAAAAAFBBBBBBBBBBBBAAABBB
BAAAAAAIAAAAIAAAAIAAAAAFBBAAAAFBBBBBBBBBBBBBAAABBB
BAAAFBBBBBBBBBBBBBBBBBBBBBAAABBBBBBBBAAAAAAAAAABBB
BAAABBBBBBBBBBBBBBBBBBBBBBAAABBBBBBBBAAAAAAAAAABBB
BAAABBBBBBBBBBBBBBBBBBBBBBAAADCDCDCDCAAAAAAAAAABBB
BAAADBBAAAAAAAAAAAAAAADBBBAAAAAAAAAAAAAAAAAAAAABBB
BAAAAAAAAAAAAAAAAAAAAAADBBAAAAAAAAAAAAAAAAAAAAABBB
BEAAAAAAAAAIAAAAAIAAAAAADBAAAAAAAAAAAAAAAAAAAAABBB
BBEAIAAAIABBBAAABBBAAAAAABAAABBBBBBBBAAAAIAAIAABBB
BBBBBBBBBBBBBBBBBBBBBEAAABAAABBBBBBBBAABBBBBBBBBBB
BBBBBBBBBBBBBBBBBBBBBBAAABAAABBBBBBBBAABBBBBBBBBBB
BBBBBBBBBBBBBBBBBBBBBCAAABAAABBBBBBBBAABBBBBBBBBBB
BBCAAAAAAAAAAAAAAAAAAAAAABAAABBBBBBBCAABBBBBBBBBBB
BCAAAAAAAAAAAAAAAAAAAAAAFBAAABBBDCDCAAABBBBBBBBBBB
BAAAAIAAAIAAAIAAAIAAAIAFBBAAABBBAAAAAAFBBBBBBBBBBB
BAAAFBBBBBBBBBBBBBBBBBBBBBAAABBBAAAAAFBBBBBBBBBBBB
BAAABBBBBBBBBBBBBBBBBBBBBCAAABBBAAAAFBBBBBBBBBBBBB
BAAADBBBBBBBBBBBBBBBBBBBCAAAABBBAAAABBBBBBBBBBBBBB
BAAAAAAAAAAAAAAAAAAAAAAAAAAAABBBAAAFBBBBBBBBBBBBBB
BEAAAAAAAAAAAAAAAAAAAAAAAAAAFBBBAAFBBBBBBBBBBBBBBB
BBEAAAAAAAAAAAAAAAAAAAAAAAAFBBBBAABBBBBBBBBBBBBBBB
BBBBBBBBBBBBBBBBBBBBBBBBBBBBBBBBAAAAAAABBBBBBBBBBB
BBBBBBBBBBBBBBBBBBBBBBBBBBBBBBBBAAAAAAGBBBBBBBBBBB
BBBBBBBBBBBBBBBBBBBBBBBBBBBBBBBBBBBBBBBBBBBBBBBBBB
