BBBBBBBBBBBBBBBBBBBBBBBBBBBBBBBBBBBBBBBBBBBBBBBBBB
BAAAAAAAAAAABBAAAABBCAAAAAAAADBBBBDCDCDCDCDCDCDCBB
BAAAAAAAAAAABBAAAABBAAAAAAAAAABBBBCDCDCDCDCDCDCDBB
BAAAAAAAAAAABBAAAABBEAHAAAAAAFBBBBAAAAAAAAAAAAAABB
BAAAAAAAAAAABBAAAADBBBBEAAFBBBBBBBAAAAAAAAAAAAAABB
BAAAAAFBBEAABBAGAAADBBBBAABBBBBBBBAAAAAAAIAAGAAABB
BAAAAABCDBAABBBBBEAADBBBAABBBBBBBBAAABBBBBBBBBAABB
BBBCAABCDBAABBBBBBEAADBBAAAAAAAAAAAAABFBFFEBBBAABB
BBCAAABCDBAAAAADBBBEAADBAAAAAAAAIAAAABBFBDBEBBAABB
BBAAAABCDBAAAAAABBBBEAADAABBBBBBBBBBBBFBFBDBBBAABB
BBAAAFBCDBAAAAAABBBBBEAAAABBBDDDDDDDDBFEBFBBBBAABB
BBAAFBBEFBAAAAGFBBBDCBEAAADBBDAAAAAADBDBEBBBBBAABB
BCAABBBEFBBBBBBBBBBFEBBEAAADBDAAAAAADBBDBBBBBBAABB
BAAABCBEFBDBBBBBBFEDCFEBAAAADDAAAAAADBBBBBBBBBAABB
BAAABCBEFBDBBBBBBDBCDBCBAAAAAAAAAAAADBBBBBBBBBAABB
BAAABCBEFBDBBBBBBFBBBBEBAAEAAAAAAAAADBBBBCBBBBAABB
BAAABBBBBBBBBBBBBBDDCCBBAABEAAAABBBBBBBBCBBBBBAABB
BAAAAAAAAAAAAAAAADBBBBBBAABDEAAADBBBBBBCBFBBBBAABB
BAAAAAAAAAAAAAAAAADBBBBBAABDDEAAADBBBBCBFCBAAAAABB
BAAAAAAIAAAAAAAAAAADBBBBAABBDDEAAADBBCCFCCBAAAAABB
BBBBBBBBBBBBBAAABEAADBBBAABDBDDEAAADBEEDEEBAAAAABB
BBDBEEEEEEEEBAAABBEAADBBAABCDADDEAAADBEBDEBAABBBBB
BBBDBEAEEEAEBAAABBBEAADBAABEFAFFBEAAADBEBDBAABBBBB
BBDBDBEEEAEEBAAABBCBEAADAABFBFFBBBEAAADBEBBAABBBBB
BBBDBDBEEEEEBAAABCCDBEAAAABBFFBCDBBEAAADBEBAABBBBB
BBDBDBDBEEEEBAAABCCDDBEAAABFFBCCDDBBEAAADBBAABBBBB
BBBDBDBDBEAEBAAABCCCDDBEAABFBCCCDDDBBEAAADBAABBBBB
BBDBDBDBDBEEBAAABCCDCDDBAABBCCCCDDDDBBEAAADAABBBBB
BBBDBDBDBDBEBAAABCCCDCDBAABCCCDCDCDDDBBEAAAAAAAAAB
BBDBDBDBDBDBBAAABCCDCDDBAABBBBBBBBBBBBBBEAAAAAAAAB
BBBDBDBDBDBDBAIABCDCDCDBAIAAAAAAAAAAAAAAAAAIAAAGAB
BBBBBBBBBBBBBBBBBBBBBBBBBBBBBBBBBBBBBBBBBBBBBBBBBB
