BBBBBBBBBBBBBBBBBBBBBBBBBBBBBBBBBBBBBBBBBBBBBBBBBB
BAAAAAAAAAAABBAAAABBCAAAAAAAADBBBBDCDCDCDCDCDCDCBB
BAAAAAAAAAAABBAAAABBAAAAAAAAAABBBBCDCDCDCDCDCDCDBB
BAAAAAAAAAAABBAAAABBEAHAAAAAAFBBBBAAAAAAAAAAAAAABB
BAAAAAAAAAAABBAAAADBBBBEAAFBBBBBBBAAAAAAAAAAAAAABB
BAAAAAFBBEAABBAGAAADBBBBAABBBBBBBBAAAAAAAIAAGAAABB
BAAAAABCDBAABBBBBEAADBBBAABBBBBBBBAAABBBBBBBBBAABB
BBBCAABCDBAABBBBBBEAADBBAAAAAAAAAAAAABFBFFEBBBAABB
BBCAAABCDBAAAAADBBBEAADBAAAAAAAAIAAAABBFBDBEBBAABB
BBAAAABCDBAAAAAABBBBEAADAABBBBBBBBBBBBFBFBDBBBAABB
BBAAAFBCDBAAAAAABBBBBEAAAABBBDDDDDDDDBFEBFBBBBAABB
BBAAFBBEFBAAAAGFBBBDCBEAAABBBDAAAAAADBDBEBBBBBAABB
BCAABBBEFBBBBBBBBBBFEBBEAADBBDAAAAAADBBDBBBBBBAABB
BAAABCBEFBDBBBBBBFEDCFEBAAADBDAAAAAADBBBBBBBBBAABB
BAAABCBEFBDBBBBBBDBCDBCBAAAADAAAAAAADBBBBBBBBBAABB
BAAABCBEFBDBBBBBBFBBBBEBAAEAAAAAAAAADBBBBCBBBBAABB
BAAABBBBBBBBBBBBBBDDCCBBAABEAAAABBBBBBBBCBBBBBAABB
BAAAAAAAAAAAAAAAADBBBBBBAABDEAAABBBBBBBCBFBBBBAABB
BAAAAAAAAAAAAAAAAADBBBBBAABDDEAADBBBBBCBFCBAAAAABB
BAAAAAAIAAAAAAAAAAADBBBBAABBDDEAADBBBCCFCCBAAAAABB
BBBBBBBBBBBBBAAABEAADBBBAABDBDDEAADBBEEDEEBAAAAABB
BBDBEEEEEEEEBAAABBEAADBBAABCDADDEAADBBEBDEBAABBBBB
BBBDBEAEEEAEBAAABBBEAADBAABEFAFFBEAADBBEBDBAABBBBB
BBDBDBEEEAEEBAAABBCBEAADAABFBFFBBBEAADBBEBBAABBBBB
BBBDBDBEEEEEBAAABCCDBEAAAABBFFBCDBBEAADBBEBAABBBBB
BBDBDBDBEEEEBAAABCCDDBEAAABFFBCCDDBBEAADBBBAABBBBB
BBBDBDBDBEAEBAAABCCCDDBEAABFBCCCDDDBBEAADBBAABBBBB
BBDBDBDBDBEEBAAABCCDCDDBAABBCCCCDDDDBBEAADBAABBBBB
BBBDBDBDBDBEBAAABCCCDCDBAABCCCDCDCDDDBBEAADAAAAAAB
BBDBDBDBDBDBBAAABCCDCDDBAABBBBBBBBBBBBBBEAAAAAAAAB
BBBDBDBDBDBDBAIABCDCDCDBAIAAAAAAAAAAAAAAAAAIAAAGAB
BBBBBBBBBBBBBBBBBBBBBBBBBBBBBBBBBBBBBBBBBBBBBBBBBB
