BBBBBBBBBBBBBBBBBBBBBBBBBBBBBBBBBBBBBBBBBBBBBBBBBB
BBBBCBBBBBBBBBBDBBCAAAAADBCAAAAAAADBAAAAAABAAAAAAB
BBBCABBBBBBBBBBGDBAAAAAAABAAAAAAAAABAAAAAABAAAAAAB
BBBAABBBBBBBBBBAABAABBBEAAAAFBBBEAABAABBBBBBBAABBB
BBBAABBBBBBBBBBAABAABBBBBBAABBBBBAABAABBBBBBBAABBB
BBBAABBBBBBBBBBAABAABBBBBBAABBBBBAABAABBBBBBBAABBB
BBBAABBBBBBBBBBAABAABBBBBBAABBBBBAABAABBBBBBBAABBB
BBBAABBBBBBBBBBAABAABBBBBBAABBBBBAABAABBBBBBBAABBB
BBBAABBBBBBBBBBAABAABBBBBBAABBBBBAABAABBBBBBBAABBB
BBBAABBBBBBBBBBAABAABBBBBBAABBBBBAABAABBBBBBBAABBB
BBBAABBBBBBBBBBAABAABBBBBBAABBBBBAABAABBBBBBBAABBB
BBBAABBBBBBBBBBAABAABBBBBBAABBBBBAABAAAAABBBBAABBB
BBBAABBBBBBBBBBAABAABBBBBBAABBBBBAABAAAAGBBBBAABBB
BBBAABBBBBBBBBBAABAABBBBBBAABBBBBAABAABBBBBBBAABBB
BBBAABBBBCDBBBBAABAAAAAADBAABBBBBAABAABBBBBBBAABBB
BBBAABBBBAABBBBAABEGAAAAABAABBBBBAABAABBBBBBBAABBB
BBBAABBBBAABBBBAABBBBBEAABAABBBBBAABAABBBBBBBAABBB
BBBAABBBBAABBBBAABBBBBBAABAABBBBBAABAABBBBBBBAABBB
BBBAABBBBAABBBBAABBBBBBAABAABBBBBAABAABBBBBBBAABBB
BBBAABBBBAABBBBAABBBBBBAABAABBBBBAABAABBBBBBBAABBB
BBBAABBBBAABBBBAABBBBBBAABAABBBBBAABAABBBBBBBAABBB
BBBAABBBBAABBBBAABBBBBBAABAABBBBBAABAABBBBBBBAABBB
BBBAABBBBAABBBBAABBBBBBAABAABBBBBAABAABBBBBBBAABBB
BBBAABBBBAABBBBAABBBBBBAABAABBBBBAABAABBBBBBBAABBB
BBBAABBBBAABBBBAABBBBBBAABAABBBBBAABAABBBBBBBAABBB
BBBAADBBBAABBBCAABBBBBBAABAABBBBBAABAABBBBBBBAABBB
BBBEAADBBAABBCAAFBBBBBCAABAADBBBCAAAAABBBBBBBAABBB
BBBBEAADCAADCAAFBBAAAAAAABAAAAAAAAABAABBBBBBBAABBB
BBBBBEHAAAAAAAAAAAAAAAAAFBEAAAAAAGFBAABBBBBBBAGBBB
BBBBBBBBBBBBBBBBBBBBBBBBBBBBBBBBBBBBBBBBBBBBBBBBBB
BBBBBBBBBBBBBBBBBBBBBBBBBBBBBBBBBBBBBBBBBBBBBBBBBB
BBBBBBBBBBBBBBBBBBBBBBBBBBBBBBBBBBBBBBBBBBBBBBBBBB
