BBBBBBBBBBBBBBBBBBBBBBBBBBBBBBBBBBBBBBBBBBBBBBBBBB
BBBBCBBBBBBBBBBDBBCAAAAADBCAAAAAAADBAAAAAAAAAAAAAB
BBBCABBBBBBBBBBGDBAAAAAAABAAAAGAAAABAAAAAAAAAAAAAB
BBBAABBBBBBBBBBAABAABBBEAAAAFBBBEAABAABBBBBBBAABBB
BBBAABBBBBBBBBBAABAABBBBBBAABBBBBAABAABBBBBBBAABBB
BBBAABBBBBBBBBBAABAABBBBBBAABBBBBAABAABBBBBBBAABBB
BBBAABBBBBBBBBBAABAABBBBBBAABBBBBAABAABBBBBBBAABBB
BBBAABBBBBBBBBBAABAABBBBBBAABBBBBAABAABBBBBBBAABBB
BBBAABBBBBBBBBBAABAABBBBBBAABBBBBAABAABBBBBBBAABBB
BBBAABBBBBBBBBBAABAABBBBBBAABBBBBAABAABBBBBBBAABBB
BBBAABBBBBBBBBBAABAABBBBBBAABBBBBAABAABBBBBBBAABBB
BBBAABBBBBBBBBBAABAABBBBBBAABBBBBAABAAAAABBBBAABBB
BBBAABBBBBBBBBBAABAABBBBBBAABBBBBAABAAAAGBBBBAABBB
BBBAABBBBBBBBBBAABAABBBBBBAABBBBBAABAABBBBBBBAABBB
BBBAABBBBCDBBBBAABAAAAAADBAABBBBBAABAABBBBBBBAABBB
BBBAABBBBAABBBBAABEAAAAAABAABBBBBAABAABBBBBBBAABBB
BBBAABBBBAABBBBAABBBBBEAABAABBBBBAABAABBBBBBBAABBB
BBBAABBBBAABBBBAABBBBBBAABAABBBBBAABAABBBBBBBAABBB
BBBAABBBBAABBBBAABBBBBBAABAABBBBBAABAABBBBBBBAABBB
BBBAABBBBAABBBBAABBBBBBAABAABBBBBAABAABBBBBBBAABBB
BBBAABBBBAABBBBAABBBBBBAABAABBBBBAABAABBBBBBBAABBB
BBBAABBBBAABBBBAABBBBBBAABAABBBBBAABAABBBBBBBAABBB
BBBAABBBBAABBBBAABBBBBBAABAABBBBBAABAABBBBBBBAABBB
BBBAABBBBAABBBBAABBBBBBAABAABBBBBAABAABBBBBBBAABBB
BBBAABBBBAABBBBAABBBBBBAABAABBBBBAABAABBBBBBBAABBB
BBBAADBBBAABBBCAABBBBBBAABAABBBBBAABAABBBBBBBAABBB
BBBEAADBBAABBCAAFBBBBBCAABAADBBBCAAAAABBBBBBBAABBB
BBBBEAADCAADCAAFBBAAAAAAABAAAAAAAAABAABBBBBBBAABBB
BBBBBEHAAAAAAAAAAAAAAAAAFBEAAAAAAAFBAABBBBBBBAGBBB
BBBBBBBBBBBBBBBBBBBBBBBBBBBBBBBBBBBBBBBBBBBBBBBBBB
BBBBBBBBBBBBBBBBBBBBBBBBBBBBBBBBBBBBBBBBBBBBBBBBBB
BBBBBBBBBBBBBBBBBBBBBBBBBBBBBBBBBBBBBBBBBBBBBBBBBB
